1111111111111111111
100P00000000C0E0111
1111111111111111111