1111111111111111111
100P000C0000CE11111
1111111111111111111