111111111
10C0E0001
100000001
1000P0001
100000001
111111111