111111111111111111111111111111111
1PCC0CCCCCCCCCCCCCCCCCCCCCCCCCCC1
1CCCCCCCCCCCCCCCCCCCCCCCCCCCCCCC1
1TTTTTTTTTTTTTTTTTTTTTTT0TTTTTTC1
1CCCCCCCCCCCCCCCCCCCCCCCCCCCCCCC1
1TTTTTTTTTTTTTTTTTTTTTTTTTT0TTTT1
1CCCCCC100CCCCCCC0CCCCCCCCCCCCCC1
1TTTT0TT0TTTTTTTTTTTTTTTTTTTTTTC1
1CCCCCCCCCTCCCCCCCCCCCCCCCCCCCCC1
1TTTTT0TTTTTTT0TTTTTTTTTTTTTTTTT1
1CCCCCCCCCCCCCCCCCCCCCCCCCCCCCCC1
1TTTTT0TTTTT1TTTTT0TTTTTTTTTTTTC1
1CCCCCCCCCCCCCTCCCCCCCCCCCCCCCCC1
1TTTTTTTTTTT0TTTTTTTTTTTTTTTTTTT1
1CCCCCCCCCCCCCCCCCCCCCCCCCCCCCCC1
1TTTTTTTTTTTT0TTTTTTTTTTTTTTTTTC1
1CCCCCCCCCCCCCCCCC1CCCCCCCCCCCCC1
1T0TTTTTTTTTTTT0TTTTTTTT0TTTTTTT1
1CCCCCCCCCCCCCCCCCCCCCCCCCCCCCCC1
1TTTTTTTT0TTTTTTTTTTTTT0TTTTTTTC1
1CCCCCCCCCCCCCCCC1CCCCCCCCCCCCCC1
1TTTTTTTTTTTTTTTTTTTT0TTTTT0TTTT1
1CCCCCCCCCCCCCCCCCCCCCCCCCCCCCCC1
1TTT0TTTTTTTTTTTTTTTTTTTTTTTTTTC1
1CCCCCCCCCCCCCC1CCCCC1CCCCCCCCCC1
1TTTTTT0TTTTTTTTTT0TTTTTTTT0TTTT1
1CCC0CCC0C0CCCCCC000CCCCCCCCCCE01
111111111111111111111111111111111