11111111111111111111111111111111111111
1PCCCCCCCCCCCCCCCCCCCCCCCCCCCC00000C01
1CCCCCCCCCCCCCCCCCCCCCCCCCCCCC00000C01
1CCCCCCCCCCCCCCCCCCCCCCCCCCCCC00000C01
1CCCCCCCCCCCCCCCCCCCCCCCCCCCCC00000C01
1CCCCCCCCCCCCCCCCCCCCCCCCCCCCCC0000001
1CCCCCCCCCCCCCCCCCCCCCCCCCCCCC00000C01
1CCCCCCCCCCCCCCCCCCCCCCCCCCCCCC0000001
1CCCCCCCCCCCCCCCCCCCCCCCCCCCCC00000C01
1CCCCCCCCCCCCCCCCCCCCCCCCCCCCCC0000001
1CCCCCCCCCCCCCCCCCCCCCCCCCCCCC00000C01
1CCCCCCCCCCCCCCCCCCCCCCCCCCCCC00000C01
1CCCCCCCCCCCCCCCCCCECCCCCCCCCC00000C01
11111111111111111111111111111111111111