1111111111111111111111111111111111
10000000000000C00000C0000000000011
10000000000000C00000C0001111000011
1010010100100000101001001E10001011
1010010010101010001001000100010111
1P0000000C00C0000000000000000000C1
1111111111111111111111111111111111