111111111111111111
1P100001C0000000E1
100001011111100111
101111T1T0001001C1
100001010000110001
1C111100010000C001
101000010111111111
10111C010000000001
1010CC011TTTT111C1
1C1010000000000101
1010001100010T01C1
1000C0011111010101
1C0010010C01C101C1
111110011001010101
1T0C0000C00T010001
111111111111111111