1111111
1C0C0E1
10TTTT1
1C0C0C1
1TTTT01
1C0C0C1
10TTTT1
1C0C0C1
1TTTT01
1C0C0C1
10TTTT1
1C0C0C1
1TTTT01
1C0C0C1
1PTTTT1
1111111